╔════════◫═══════◫═══════╦═╣  ╠═╦═══════◫═════════◫══════════╗
║    ⚔                ⚔  ║      ║   ⛏     ❤❤❤❤❤          ⛏   ║
║          ◓             ║      ║          ❤❤❤❤❤             ║
║        ┏━━━━┓          ║      ║          ❤❤❤❤❤             ║
║       ◐┃    ┃◑         ╩      ╩          ❤❤❤❤❤             ║
║        ┃    ┃                                              ║
║       ◐┃    ┃◑         ╦      ╦                            ║
║        ┖━━━━┚          ║      ║                            ║
║          ◒             ║      ║                            ║
║                        ║      ║                            ║
║                        ║      ║                            ║
╠═══════╣       ╠════════╣      ╠════════════════════════════╣
║☱☱           ☹          ║      ║⚗ ⚖ ⚗ ⚖ ⚗ ⚖                 ║
║☰☰                      ║      ║                            ║
║                        ╩      ╩                            ║
║                                                            ║
║                        ╦      ╦                            ║
║                        ║      ║                            ║
╚═══════◫════════◫═══════╩══════╩═════════◫═══════◫══════════╝